{"Depot":"A","station": "ABCDEFGHIJKLMNOPQRSTUVWXYZabcdefghijklmnopqrstuvwx", "adjencyMatrix":
[[9, 7, 7, 8, 6, 8, 7, 5, 5, 9, 10, 9, 7, 9, 7, 9, 7, 10, 5, 5, 15, 0, 0, 0, 0, 0, 0, 0, 0, 0, 0, 0, 0, 0, 0, 0, 0, 0, 0, 0, 20, 0, 0, 0, 0, 0, 0, 0, 0, 0],
[7, 6, 5, 6, 5, 7, 6, 4, 4, 7, 8, 7, 5, 7, 5, 7, 6, 8, 4, 4, 0, 0, 0, 0, 0, 0, 0, 0, 0, 0, 0, 0, 0, 0, 0, 0, 0, 0, 0, 0, 0, 0, 0, 0, 0, 0, 0, 0, 0, 0], 
[7, 5, 6, 7, 5, 6, 5, 4, 4, 7, 8, 7, 6, 7, 6, 7, 5, 8, 4, 4, 0, 0, 0, 0, 0, 0, 0, 0, 0, 0, 0, 0, 0, 0, 0, 0, 0, 0, 0, 0, 0, 0, 0, 0, 0, 0, 0, 0, 0, 0],
[8, 6, 7, 9, 7, 8, 6, 5, 5, 8, 10, 8, 7, 8, 7, 8, 6, 10, 5, 5, 0, 0, 0, 0, 0, 0, 0, 0, 0, 0, 0, 0, 0, 0, 0, 0, 0, 0, 0, 0, 0, 0, 0, 0, 0, 0, 0, 0, 0, 0],
[6, 5, 5, 7, 6, 7, 5, 4, 4, 6, 8, 6, 5, 6, 5, 6, 5, 8, 4, 4, 0, 0, 0, 0, 0, 0, 0, 0, 0, 0, 0, 0, 0, 0, 0, 0, 0, 0, 0, 0, 0, 0, 0, 0, 0, 0, 0, 0, 0, 0],
[8, 7, 6, 8, 7, 9, 7, 5, 5, 8, 10, 8, 6, 8, 6, 8, 7, 10, 5, 5, 0, 0, 0, 0, 0, 0, 0, 0, 0, 0, 0, 0, 0, 0, 0, 0, 0, 0, 0, 0, 0, 0, 0, 0, 0, 0, 0, 0, 0, 0],
[7, 6, 5, 6, 5, 7, 6, 4, 4, 7, 8, 7, 5, 7, 5, 7, 6, 8, 4, 4, 0, 0, 0, 0, 0, 0, 0, 0, 0, 0, 0, 0, 0, 0, 0, 0, 0, 0, 0, 0, 0, 0, 0, 0, 0, 0, 0, 0, 0, 0],
[5, 4, 4, 5, 4, 5, 4, 3, 3, 5, 6, 5, 4, 5, 4, 5, 4, 6, 3, 3, 0, 0, 0, 0, 0, 0, 0, 0, 0, 0, 0, 0, 0, 0, 0, 0, 0, 0, 0, 0, 0, 0, 0, 0, 0, 0, 0, 0, 0, 0], 
[5, 4, 4, 5, 4, 5, 4, 3, 3, 5, 6, 5, 4, 5, 4, 5, 4, 6, 3, 3, 0, 0, 0, 0, 0, 0, 0, 0, 0, 0, 0, 0, 0, 0, 0, 0, 0, 0, 0, 0, 0, 0, 0, 0, 0, 0, 0, 0, 0, 0], 
[9, 7, 7, 8, 6, 8, 7, 5, 5, 9, 10, 9, 7, 9, 7, 9, 7, 10, 5, 5, 0, 0, 0, 0, 0, 0, 0, 0, 0, 0, 0, 0, 0, 0, 0, 0, 0, 0, 0, 0, 0, 0, 0, 0, 0, 0, 0, 0, 0, 0],
[10, 8, 8, 10, 8, 10, 8, 6, 6, 10, 12, 10, 8, 10, 8, 10, 8, 12, 6, 6, 0, 0, 0, 0, 0, 0, 0, 0, 0, 0, 0, 0, 0, 0, 0, 0, 0, 0, 0, 0, 0, 0, 0, 0, 0, 0, 0, 0, 0, 0],
[9, 7, 7, 8, 6, 8, 7, 5, 5, 9, 10, 9, 7, 9, 7, 9, 7, 10, 5, 5, 0, 0, 0, 0, 0, 0, 0, 0, 0, 0, 0, 0, 0, 0, 0, 0, 0, 0, 0, 0, 0, 0, 0, 0, 0, 0, 0, 0, 0, 0],
[7, 5, 6, 7, 5, 6, 5, 4, 4, 7, 8, 7, 6, 7, 6, 7, 5, 8, 4, 4, 0, 0, 0, 0, 0, 0, 0, 0, 0, 0, 0, 0, 0, 0, 0, 0, 0, 0, 0, 0, 0, 0, 0, 0, 0, 0, 0, 0, 0, 0],
[9, 7, 7, 8, 6, 8, 7, 5, 5, 9, 10, 9, 7, 9, 7, 9, 7, 10, 5, 5, 0, 0, 0, 0, 0, 0, 0, 0, 0, 0, 0, 0, 0, 0, 0, 0, 0, 0, 0, 0, 0, 0, 0, 0, 0, 0, 0, 0, 0, 0],
[7, 5, 6, 7, 5, 6, 5, 4, 4, 7, 8, 7, 6, 7, 6, 7, 5, 8, 4, 4, 0, 0, 0, 0, 0, 0, 0, 0, 0, 0, 0, 0, 0, 0, 0, 0, 0, 0, 0, 0, 0, 0, 0, 0, 0, 0, 0, 0, 0, 0],
[9, 7, 7, 8, 6, 8, 7, 5, 5, 9, 10, 9, 7, 9, 7, 9, 7, 10, 5, 5, 0, 0, 0, 0, 0, 0, 0, 0, 0, 0, 0, 0, 0, 0, 0, 0, 0, 0, 0, 0, 0, 0, 0, 0, 0, 0, 0, 0, 0, 0],
[7, 6, 5, 6, 5, 7, 6, 4, 4, 7, 8, 7, 5, 7, 5, 7, 6, 8, 4, 4, 0, 0, 0, 0, 0, 0, 0, 0, 0, 0, 0, 0, 0, 0, 0, 0, 0, 0, 0, 0, 0, 0, 0, 0, 0, 0, 0, 0, 0, 0], 
[10, 8, 8, 10, 8, 10, 8, 6, 6, 10, 12, 10, 8, 10, 8, 10, 8, 12, 6, 6, 0, 0, 0, 0, 0, 0, 0, 0, 0, 0, 0, 0, 0, 0, 0, 0, 0, 0, 0, 0, 0, 0, 0, 0, 0, 0, 0, 0, 0, 0],
[5, 4, 4, 5, 4, 5, 4, 3, 3, 5, 6, 5, 4, 5, 4, 5, 4, 6, 3, 3, 0, 0, 0, 0, 0, 0, 0, 0, 0, 0, 0, 0, 0, 0, 0, 0, 0, 0, 0, 0, 0, 0, 0, 0, 0, 0, 0, 0, 0, 0],
[5, 4, 4, 5, 4, 5, 4, 3, 3, 5, 6, 5, 4, 5, 4, 5, 4, 6, 3, 3, 0, 0, 0, 0, 0, 0, 0, 0, 0, 0, 0, 0, 0, 0, 0, 0, 0, 0, 0, 0, 0, 0, 0, 0, 0, 0, 0, 0, 0, 0],
[15, 0, 0, 0, 0, 0, 0, 0, 0, 0, 0, 0, 0, 0, 0, 0, 0, 0, 0, 0, 9, 5, 8, 8, 8, 10, 8, 8, 8, 10, 7, 9, 7, 9, 9, 7, 9, 8, 6, 6, 15, 0, 0, 0, 0, 0, 0, 0, 0, 0],
[0, 0, 0, 0, 0, 0, 0, 0, 0, 0, 0, 0, 0, 0, 0, 0, 0, 0, 0, 0, 5, 3, 5, 5, 5, 6, 5, 5, 5, 6, 4, 5, 4, 5, 5, 4, 5, 5, 4, 4, 0, 0, 0, 0, 0, 0, 0, 0, 0, 0],
[0, 0, 0, 0, 0, 0, 0, 0, 0, 0, 0, 0, 0, 0, 0, 0, 0, 0, 0, 0, 8, 5, 9, 9, 9, 10, 9, 8, 8, 10, 7, 8, 7, 8, 8, 7, 8, 9, 7, 7, 0, 0, 0, 0, 0, 0, 0, 0, 0, 0],
[0, 0, 0, 0, 0, 0, 0, 0, 0, 0, 0, 0, 0, 0, 0, 0, 0, 0, 0, 0, 8, 5, 9, 9, 9, 10, 9, 8, 8, 10, 7, 8, 7, 8, 8, 7, 8, 9, 7, 7, 0, 0, 0, 0, 0, 0, 0, 0, 0, 0],
[0, 0, 0, 0, 0, 0, 0, 0, 0, 0, 0, 0, 0, 0, 0, 0, 0, 0, 0, 0, 8, 5, 9, 9, 9, 10, 9, 8, 8, 10, 7, 8, 7, 8, 8, 7, 8, 9, 7, 7, 0, 0, 0, 0, 0, 0, 0, 0, 0, 0],
[0, 0, 0, 0, 0, 0, 0, 0, 0, 0, 0, 0, 0, 0, 0, 0, 0, 0, 0, 0, 10, 6, 10, 10, 10, 12, 10, 10, 10, 12, 8, 10, 8, 10, 10, 8, 10, 10, 8, 8, 0, 0, 0, 0, 0, 0, 0, 0, 0, 0],
[0, 0, 0, 0, 0, 0, 0, 0, 0, 0, 0, 0, 0, 0, 0, 0, 0, 0, 0, 0, 8, 5, 9, 9, 9, 10, 9, 8, 8, 10, 7, 8, 7, 8, 8, 7, 8, 9, 7, 7, 0, 0, 0, 0, 0, 0, 0, 0, 0, 0],
[0, 0, 0, 0, 0, 0, 0, 0, 0, 0, 0, 0, 0, 0, 0, 0, 0, 0, 0, 0, 8, 5, 8, 8, 8, 10, 8, 9, 9, 10, 6, 8, 6, 8, 8, 6, 8, 8, 7, 7, 0, 0, 0, 0, 0, 0, 0, 0, 0, 0],
[0, 0, 0, 0, 0, 0, 0, 0, 0, 0, 0, 0, 0, 0, 0, 0, 0, 0, 0, 0, 8, 5, 8, 8, 8, 10, 8, 9, 9, 10, 6, 8, 6, 8, 8, 6, 8, 8, 7, 7, 0, 0, 0, 0, 0, 0, 0, 0, 0, 0],
[0, 0, 0, 0, 0, 0, 0, 0, 0, 0, 0, 0, 0, 0, 0, 0, 0, 0, 0, 0, 10, 6, 10, 10, 10, 12, 10, 10, 10, 12, 8, 10, 8, 10, 10, 8, 10, 10, 8, 8, 0, 0, 0, 0, 0, 0, 0, 0, 0, 0],
[0, 0, 0, 0, 0, 0, 0, 0, 0, 0, 0, 0, 0, 0, 0, 0, 0, 0, 0, 0, 7, 4, 7, 7, 7, 8, 7, 6, 6, 8, 6, 7, 6, 7, 7, 6, 7, 7, 5, 5, 0, 0, 0, 0, 0, 0, 0, 0, 0, 0],
[0, 0, 0, 0, 0, 0, 0, 0, 0, 0, 0, 0, 0, 0, 0, 0, 0, 0, 0, 0, 9, 5, 8, 8, 8, 10, 8, 8, 8, 10, 7, 9, 7, 9, 9, 7, 9, 8, 6, 6, 0, 0, 0, 0, 0, 0, 0, 0, 0, 0],
[0, 0, 0, 0, 0, 0, 0, 0, 0, 0, 0, 0, 0, 0, 0, 0, 0, 0, 0, 0, 7, 4, 7, 7, 7, 8, 7, 6, 6, 8, 6, 7, 6, 7, 7, 6, 7, 7, 5, 5, 0, 0, 0, 0, 0, 0, 0, 0, 0, 0], 
[0, 0, 0, 0, 0, 0, 0, 0, 0, 0, 0, 0, 0, 0, 0, 0, 0, 0, 0, 0, 9, 5, 8, 8, 8, 10, 8, 8, 8, 10, 7, 9, 7, 9, 9, 7, 9, 8, 6, 6, 0, 0, 0, 0, 0, 0, 0, 0, 0, 0],
[0, 0, 0, 0, 0, 0, 0, 0, 0, 0, 0, 0, 0, 0, 0, 0, 0, 0, 0, 0, 9, 5, 8, 8, 8, 10, 8, 8, 8, 10, 7, 9, 7, 9, 9, 7, 9, 8, 6, 6, 0, 0, 0, 0, 0, 0, 0, 0, 0, 0],
[0, 0, 0, 0, 0, 0, 0, 0, 0, 0, 0, 0, 0, 0, 0, 0, 0, 0, 0, 0, 7, 4, 7, 7, 7, 8, 7, 6, 6, 8, 6, 7, 6, 7, 7, 6, 7, 7, 5, 5, 0, 0, 0, 0, 0, 0, 0, 0, 0, 0],
[0, 0, 0, 0, 0, 0, 0, 0, 0, 0, 0, 0, 0, 0, 0, 0, 0, 0, 0, 0, 9, 5, 8, 8, 8, 10, 8, 8, 8, 10, 7, 9, 7, 9, 9, 7, 9, 8, 6, 6, 0, 0, 0, 0, 0, 0, 0, 0, 0, 0],
[0, 0, 0, 0, 0, 0, 0, 0, 0, 0, 0, 0, 0, 0, 0, 0, 0, 0, 0, 0, 8, 5, 9, 9, 9, 10, 9, 8, 8, 10, 7, 8, 7, 8, 8, 7, 8, 9, 7, 7, 0, 0, 0, 0, 0, 0, 0, 0, 0, 0],
[0, 0, 0, 0, 0, 0, 0, 0, 0, 0, 0, 0, 0, 0, 0, 0, 0, 0, 0, 0, 6, 4, 7, 7, 7, 8, 7, 7, 7, 8, 5, 6, 5, 6, 6, 5, 6, 7, 6, 6, 0, 0, 0, 0, 0, 0, 0, 0, 0, 0],
[0, 0, 0, 0, 0, 0, 0, 0, 0, 0, 0, 0, 0, 0, 0, 0, 0, 0, 0, 0, 6, 4, 7, 7, 7, 8, 7, 7, 7, 8, 5, 6, 5, 6, 6, 5, 6, 7, 6, 6, 0, 0, 0, 0, 0, 0, 0, 0, 0, 0],
[20, 0, 0, 0, 0, 0, 0, 0, 0, 0, 0, 0, 0, 0, 0, 0, 0, 0, 0, 0, 15, 0, 0, 0, 0, 0, 0, 0, 0, 0, 0, 0, 0, 0, 0, 0, 0, 0, 0, 0, 9, 10, 9, 7, 10, 5, 7, 7, 8, 5],
[0, 0, 0, 0, 0, 0, 0, 0, 0, 0, 0, 0, 0, 0, 0, 0, 0, 0, 0, 0, 0, 0, 0, 0, 0, 0, 0, 0, 0, 0, 0, 0, 0, 0, 0, 0, 0, 0, 0, 0, 10, 12, 10, 8, 12, 6, 8, 8, 10, 6],
[0, 0, 0, 0, 0, 0, 0, 0, 0, 0, 0, 0, 0, 0, 0, 0, 0, 0, 0, 0, 0, 0, 0, 0, 0, 0, 0, 0, 0, 0, 0, 0, 0, 0, 0, 0, 0, 0, 0, 0, 9, 10, 9, 7, 10, 5, 7, 7, 8, 5],
[0, 0, 0, 0, 0, 0, 0, 0, 0, 0, 0, 0, 0, 0, 0, 0, 0, 0, 0, 0, 0, 0, 0, 0, 0, 0, 0, 0, 0, 0, 0, 0, 0, 0, 0, 0, 0, 0, 0, 0, 7, 8, 7, 6, 8, 4, 5, 6, 6, 4],
[0, 0, 0, 0, 0, 0, 0, 0, 0, 0, 0, 0, 0, 0, 0, 0, 0, 0, 0, 0, 0, 0, 0, 0, 0, 0, 0, 0, 0, 0, 0, 0, 0, 0, 0, 0, 0, 0, 0, 0, 10, 12, 10, 8, 12, 6, 8, 8, 10, 6],
[0, 0, 0, 0, 0, 0, 0, 0, 0, 0, 0, 0, 0, 0, 0, 0, 0, 0, 0, 0, 0, 0, 0, 0, 0, 0, 0, 0, 0, 0, 0, 0, 0, 0, 0, 0, 0, 0, 0, 0, 5, 6, 5, 4, 6, 3, 4, 4, 5, 3],
[0, 0, 0, 0, 0, 0, 0, 0, 0, 0, 0, 0, 0, 0, 0, 0, 0, 0, 0, 0, 0, 0, 0, 0, 0, 0, 0, 0, 0, 0, 0, 0, 0, 0, 0, 0, 0, 0, 0, 0, 7, 8, 7, 5, 8, 4, 6, 5, 7, 4],
[0, 0, 0, 0, 0, 0, 0, 0, 0, 0, 0, 0, 0, 0, 0, 0, 0, 0, 0, 0, 0, 0, 0, 0, 0, 0, 0, 0, 0, 0, 0, 0, 0, 0, 0, 0, 0, 0, 0, 0, 7, 8, 7, 6, 8, 4, 5, 6, 6, 4],
[0, 0, 0, 0, 0, 0, 0, 0, 0, 0, 0, 0, 0, 0, 0, 0, 0, 0, 0, 0, 0, 0, 0, 0, 0, 0, 0, 0, 0, 0, 0, 0, 0, 0, 0, 0, 0, 0, 0, 0, 8, 10, 8, 6, 10, 5, 7, 6, 9, 5],
[0, 0, 0, 0, 0, 0, 0, 0, 0, 0, 0, 0, 0, 0, 0, 0, 0, 0, 0, 0, 0, 0, 0, 0, 0, 0, 0, 0, 0, 0, 0, 0, 0, 0, 0, 0, 0, 0, 0, 0, 5, 6, 5, 4, 6, 3, 4, 4, 5, 3]]}