{"station": "ABCDEFGHabcdef012345", 
    "adjencyMatrix":
[
[3, 5, 5, 4, 5, 5, 4, 3, 0, 0, 0, 0, 0, 0, 0, 0, 0, 0, 0, 0],
[5, 9, 8, 7, 9, 8, 6, 5, 0, 0, 0, 0, 0, 0, 0, 0, 0, 0, 0, 0],
[5, 8, 9, 7, 8, 8, 7, 5, 0, 0, 0, 0, 0, 0, 0, 0, 0, 0, 0, 0],
[4, 7, 7, 6, 7, 6, 5, 4, 0, 0, 0, 0, 0, 0, 0, 0, 0, 0, 0, 0],
[5, 9, 8, 7, 9, 8, 6, 5, 0, 0, 0, 0, 0, 0, 0, 0, 0, 0, 0, 0],
[5, 8, 8, 6, 8, 9, 7, 5, 0, 0, 0, 0, 0, 0, 0, 0, 0, 0, 0, 0],
[4, 6, 7, 5, 6, 7, 6, 4, 0, 0, 0, 0, 0, 0, 0, 0, 0, 0, 0, 0],
[3, 5, 5, 4, 5, 5, 4, 3, 15, 0, 0, 0, 0, 0, 0, 0, 20, 0, 0, 0],
[0, 0, 0, 0, 0, 0, 0, 15, 6, 5, 5, 6, 7, 5, 0, 0, 15, 0, 0, 0], 
[0, 0, 0, 0, 0, 0, 0, 0, 5, 6, 6, 7, 6, 5, 0, 0, 0, 0, 0, 0],
[0, 0, 0, 0, 0, 0, 0, 0, 5, 6, 6, 7, 6, 5, 0, 0, 0, 0, 0, 0],
[0, 0, 0, 0, 0, 0, 0, 0, 6, 7, 7, 9, 8, 7, 0, 0, 0, 0, 0, 0],
[0, 0, 0, 0, 0, 0, 0, 0, 7, 6, 6, 8, 9, 7, 0, 0, 0, 0, 0, 0],
[0, 0, 0, 0, 0, 0, 0, 0, 5, 5, 5, 7, 7, 6, 0, 0, 0, 0, 0, 0],
[0, 0, 0, 0, 0, 0, 0, 0, 0, 0, 0, 0, 0, 0, 9, 7, 7, 8, 8, 9],
[0, 0, 0, 0, 0, 0, 0, 0, 0, 0, 0, 0, 0, 0, 7, 6, 6, 7, 7, 7],
[0, 0, 0, 0, 0, 0, 20, 15, 0, 0, 0, 0, 0, 0, 7, 6, 6, 7, 7, 7],
[0, 0, 0, 0, 0, 0, 0, 0, 0, 0, 0, 0, 0, 0, 8, 7, 7, 9, 9, 8],
[0, 0, 0, 0, 0, 0, 0, 0, 0, 0, 0, 0, 0, 0, 8, 7, 7, 9, 9, 8],
[0, 0, 0, 0, 0, 0, 0, 0, 0, 0, 0, 0, 0, 0, 9, 7, 7, 8, 8, 9]]}