{"Depot":"A","station": ["A", "B", "C", "D", "E", "F", "G", "H", "I", "J", "K", "L", "M", "N", "O", "P", "Q", "R", "S", "T"],
     "adjencyMatrix": [
[0, 0, 0, 0, 0, 0, 48, 0, 51, 79, 35, 0, 0, 0, 0, 0, 0, 0, 0, 0],
[0, 0, 0, 0, 0, 0, 0, 0, 0, 0, 0, 0, 0, 0, 0, 0, 0, 0, 38, 0],
[0, 0, 36, 0, 0, 0, 0, 0, 0, 0, 0, 0, 0, 0, 0, 0, 0, 0, 54, 0],
[0, 0, 0, 166, 0, 0, 0, 0, 0, 0, 0, 0, 0, 0, 0, 0, 0, 0, 0, 98],
[0, 0, 0, 0, 0, 0, 0, 0, 0, 0, 0, 0, 0, 81, 0, 0, 0, 0, 0, 94], 
[0, 0, 0, 0, 0, 0, 0, 38, 0, 0, 0, 0, 0, 36, 0, 0, 0, 52, 0, 0],
[48, 0, 0, 0, 0, 0, 0, 0, 0, 0, 0, 0, 0, 0, 0, 0, 0, 0, 0, 0], 
[0, 0, 0, 0, 0, 38, 0, 61, 0, 0, 0, 41, 0, 0, 0, 0, 23, 0, 0, 0],
[51, 0, 0, 0, 0, 0, 0, 0, 13, 0, 0, 0, 0, 0, 0, 0, 0, 0, 0, 0],
[79, 0, 0, 0, 0, 0, 0, 0, 0, 117, 0, 0, 0, 0, 0, 0, 0, 0, 0, 0],
[35, 0, 0, 0, 0, 0, 0, 0, 0, 0, 85, 0, 0, 0, 0, 0, 67, 87, 0, 0],
[0, 0, 0, 0, 0, 0, 0, 41, 0, 0, 0, 41, 0, 31, 0, 0, 0, 0, 44, 0], 
[0, 0, 0, 0, 0, 0, 0, 0, 0, 0, 0, 0, 0, 0, 0, 0, 70, 90, 0, 86],
[0, 0, 0, 0, 81, 36, 0, 0, 0, 0, 0, 31, 0, 0, 0, 0, 0, 0, 35, 0],
[0, 0, 0, 0, 0, 0, 0, 0, 0, 0, 0, 0, 0, 0, 83, 0, 0, 80, 85, 0],
[0, 0, 0, 0, 0, 0, 0, 0, 0, 0, 0, 0, 0, 0, 0, 0, 35, 43, 0, 0],
[0, 0, 0, 0, 0, 0, 0, 23, 0, 0, 67, 0, 70, 0, 0, 35, 0, 76, 0, 0],
[0, 0, 0, 0, 0, 52, 0, 0, 0, 0, 87, 0, 90, 0, 80, 43, 76, 0, 0, 0],
[0, 38, 54, 0, 0, 0, 0, 0, 0, 0, 0, 44, 0, 35, 85, 0, 0, 0, 0, 0],
[0, 0, 0, 98, 94, 0, 0, 0, 0, 0, 0, 0, 86, 0, 0, 0, 0, 0, 0, 0]]}